Baalberge_MN	MN
Bell_Beaker_LN	LNBA
BenzigerodeHeimburg_LN	LNBA
Corded_Ware_LN	LNBA
Esperstedt_MN	MN
Halberstadt_LBA	LNBA
HungaryGamba_BA	LNBA
HungaryGamba_CA	LNBA
HungaryGamba_EN	EN
HungaryGamba_HG	HG
Iceman	MN
LaBrana1	HG
LBK_EN	EN
LBKT_EN	EN
Loschbour	HG
Motala_HG	HG
Spain_EN	EN
Spain_MN	MN
Starcevo_EN	EN
Stuttgart	EN
SwedenSkoglund_MHG	HG
SwedenSkoglund_NHG	HG
Unetice_EBA	LNBA
Yamnaya	SBA
Poltavka	SBA
Srubnaya	SBA
