Baalberge_MN	Central_MN
Bell_Beaker_LN	Central_LNBA
BenzigerodeHeimburg_LN	Central_LNBA
Corded_Ware_LN	Central_LNBA
Esperstedt_MN	Central_MN
Halberstadt_LBA	Central_LNBA
HungaryGamba_BA	Central_LNBA
HungaryGamba_CA	Central_LNBA
HungaryGamba_EN	Central_EN
HungaryGamba_HG	WHG
LaBrana1	WHG
LBK_EN	Central_EN
LBKT_EN	Central_EN
Loschbour	WHG
Motala_HG	SHG
Spain_EN	Iberia_EN
Spain_MN	Iberia_MN
Starcevo_EN	Central_EN
Stuttgart	Central_EN
SwedenSkoglund_MHG	SHG
SwedenSkoglund_NHG	SHG
Unetice_EBA	Central_LNBA
Yamnaya	Steppe_BA
Poltavka	Steppe_BA
Srubnaya	Steppe_BA
