Anatolia_Neolithic	AEN
Anatolia_Neolithic_lessThan20K	AEN
Anatolia_Neolithic_outlier	AEN
Central_MN	CEM
Hungary_EN	CEM
LBK_EN	CEM
Central_LNBA	CLB
Bell_Beaker_LN	CLB
Bell_Beaker_LN_lessThan20K	CLB
Central_LNBA_lessThan20K	CLB
Central_LNBA_outlier	CLB
Hungary_BA	CLB
Central_MN_lessThan20K	CEM
Iberia_EN	INC
Iberia_Chalcolithic	INC
Iberia_MN	INC
Motala_HG	HG
Sweden_PWC	HG
Sweden_PWC_lessThan20K	HG
Sweden_Mesolithic	HG
Afanasievo	STP
Andronovo	STP
Andronovo_outlier	STP
Poltavka	STP
Poltavka_lessThan20K	STP
Poltavka_outlier	STP
Potapovka	STP
Sintashta	STP
Srubnaya	STP
Srubnaya_lessThan20K	STP
Srubnaya_outlier	STP
Yamnaya_Kalmykia	STP
Yamnaya_Samara	STP
WHG	HG
Loschbour	HG
Stuttgart	CEM
